NO ./assets/no_texture.xpm
EA ./assets/ea_texture.xpm
WE ./assets/we_texture.xpm
SO ./assets/so_texture.xpm
F 220,100,0
C 225,30,0
1111111111111111111111111
1000000000110000000000001
1000000001110000000000001
1000000000000000000000001
1000000000000000000000001
1000000000000000000000001
1000000000000000000000001
1000000000000000000000001
1000000000001100000000001
1000000000010010000000001
1000000000110011000000001
1000001111110000111000001
1000001001000000001110001
1000001011000000000000001
1000000000000000000000001
10000000000N0000000000001
1111111111111111111111111