NO ./assets/no_texture.xpm
EA ./assets/ea_texture.xpm
WE ./assets/we_texture.xpm
SO ./assets/so_texture.xpm
F 135,111,82
C 109,109,109
1111111111111111111111111
1000000000000000000000001
1000000000000000000000001
1000000000000000000000001
1000000000000000000000001
1000000000000000000000001
1000000000000000000000001
1000000000000000000000001
1000000000000000000000001
1000000000000000000000001
1000001111100011111110011
1000000000000010000000001
1000000000000011110000001
1000000000000001000000001
1000000000000000100000001
1000000000000000000000001
10000000000000N0000000001
1000000000000000000000001
1000000000000000000000001
1000000000000000000000001
1000000000000000000000001
1001111111111000000000001
1000000000000000000000001
1000000000000000000000001
1000000000000000000000001
1000000000000000000000001
1000000000000000000000001
1111111111111111111111111
