NO ./assets/no_texture.xpm
EA ./assets/ea_texture.xpm
WE ./assets/we_texture.xpm
SO ./assets/so_texture.xpm
F 135,111,82
C 109,109,109
1111111
1000001
1000001
100E001
1111111
