NO ./assets/no_texture.xpm
EA ./assets/ea_texture.xpm
WE ./assets/we_texture.xpm
SO ./assets/so_texture.xpm
F 220,100,0
C 225,30,0
111111111
100000001
100111001
100101001
100000001
1000W0001
111111111
