NO ./assets/no_texture.xpm
EA ./assets/ea_texture.xpm
WE ./assets/we_texture.xpm
SO ./assets/so_texture.xpm
F 135,111,82
C 109,109,109
1111111111111111111111111
1000000000000000000000001
1000000000000000000000001
1000000000000000000000001
1000000000000000000000001
1000000000000000000000001
1000000000000000000000001
1000000000000000000000001
1000000000000000000000001
1000000000000000000000001
1000001111100011100010001
1000000000000000000000001
1000000000000000000000001
1000000000000000000000001
1000000000000000000000001
1000000000000000000000001
1000000000000N00000000001
1111111111111111111111111
